####################
#                  #
#                  #
#     #            #
#                  #
#                  #
#           P      #
#                  #
#                  #
#    #      Z      #
#                  #
#                # #
#       #          #
#                  #
#  #               #
####################